www.foxnews.com	R
www.breitbart.com	R
www.cnsnews.com	R
www.dailysignal.com	R
www.hotair.com	R
www.newsmax.com	R
www.patriotpost.us	R
www.blacknews.com	R
www.wnd.com	R
www.drudgereport.com	R
www.nationalreview.com	R
www.nysun.com	R
www.townhall.com	R
www.newsbusters.org	R
www.realclearpolitics.com	R
www.spectator.org	R
www.unionleader.com	R
www.washingtontimes.com	R
www.chicagotribune.com	R
www.dallasnews.com	R
www.nypost.com	R
www.omaha.com	R
www.post-gazette.com	R
www.sun-sentinel.com	R
www.dispatch.com	R
www.wsj.com	R
www.marketwatch.com	R
www.forbes.com	R
www.theamericanconservative.com	R
www.gatewaypundit.com	R
www.cbn.com	R
www.charismanews.com	R
www.commdiginews.com	R
www.conservativereview.com	R
www.theconservativetreehouse.com	R
www.donservativedailynews.com	R
www.conservativefiringline.com	R
www.grabien.com	R
www.independentsentinel.com	R
www.libertyunyielding.com	R
www.rare.us	R
www.sgtreport.com	R
www.sonsoflibertmedia.com	R
www.newswithviews.com	R
www.theblaze.com	R
www.pjmedia.com	R
www.nationalreview.com	R
www.dailycaller.com	R
www.reason.com	R
www.americanthinker.com	R
www.redstate.com	R
www.infowars.com	R
www.thenation.com	L
www.buzzfeednews.com	L
www.vox.com	L
www.washingtonpost.com	L
www.progressive.org	L
www.nytimes.com	L
www.motherjones.com	L
www.democracynow.org	L
